$ANSIBLE_VAULT;1.1;AES256
62633038376236616433616634336565363063383166623433336231353966306461653636303362
6138623666373237316335313237613430333565313331350a303032383833353237333665646233
38636365376138306130363930346138623035353263326138306437336534346638303063333665
6233396333383065610a643332386336623661363362626336353962633231343730653165313939
65336564356139646562666234393132373137376632653561363330643263613930363031313338
31336232303665333830303134646436383361383835313966613337326461306432646565333935
30623766636565636638336163323433306433623332626537396238333566376636623733646334
33643462623563353335
